NO ./textures/pennywise.xpm
EA ./textures/forest.xpm
SO ./textures/ice_truck.xpm
C                    183,182,180

WE ./textures/Pedobear.xpm

F 31,42,32

11111111111111
10000100000001
10000000000001
10100N00100001
10111111100001
11111111111111
